# UAIdx CoBoIdx AsAdIdx
    006       0       0
    001       0       1
    002       0       2
    003       0       3
    007       1       0
    005       1       1
    000       1       2
    004       1       3
    008       2       0
    009       2       1
    010       2       2
    011       2       3
    100       3       0
    101       3       1
    102       3       2
    103       3       3
    104       4       0
    105       4       1
    106       4       2
    107       4       3
    108       5       0
    109       5       1
    110       5       2
    111       5       3
    200       6       0
    201       6       1
    202       6       2
    203       6       3
    204       7       0
    205       7       1
    206       7       2
    207       7       3
    208       8       0
    209       8       1
    210       8       2
    211       8       3
    300       9       0
    301       9       1
    302       9       2
    303       9       3
    304      10       0
    305      10       1
    306      10       2
    307      10       3
    308      11       0
    309      11       1
    310      11       2
    311      11       3
