# UAIdx CoBoIdx AsAdIdx
     47       0       0
      1       0       1
      2       0       2
      3       0       3
      4       1       0
      5       1       1
      6       1       2
      7       1       3
      8       2       0
      9       2       1
     10       2       2
     11       2       3
     12       3       0
     13       3       1
     14       3       2
     15       3       3
     16       4       0
     17       4       1
     18       4       2
     19       4       3
     20       5       0
     21       5       1
     22       5       2
     23       5       3
     24       6       0
     25       6       1
     26       6       2
     27       6       3
     28       7       0
     29       7       1
     30       7       2
     31       7       3
     32       8       0
     33       8       1
     34       8       2
     35       8       3
     36       9       0
     37       9       1
     38       9       2
     39       9       3
     40      10       0
     41      10       1
     42      10       2
     43      10       3
     44      11       0
     45      11       1
     46      11       2
      0      11       3
