# UAIdx CoBoIdx AsAdIdx
    000       5       0
    001       1       3
    002       1       2
    003       1       1
    004       1       0
    005       0       0
    100       5       1
    101       2       3
    102       2       2
    103       2       1
    104       2       0
    105       0       1
    200       5       2
    201       3       3
    202       3       2
    203       3       1
    204       3       0
    205       0       2
    300       5       3
    301       4       3
    302       4       2
    303       4       1
    304       4       0
    305       0       3
