# Ch PadLayer PadRow
   0       -2     -2
   1        0      1
   2        1      2
   3        0      2
   4        2      2
   5        1      1
   6        0      3
   7        2      1
   8        1      3
   9        0      0
  10        2      3
  11       -2     -2
  12        1      0
  13        0      4
  14        2      0
  15        1      4
  16        3      2
  17        2      4
  18        3      1
  19        3      3
  20        3      0
  21        4      3
  22       -2     -2
  23        4      0
  24        5      3
  25        5      0
  26        6      3
  27        6      0
  28        6      2
  29        6      1
  30        4      2
  31        4      1
  32        5      2
  33        5      1
  34        2      7
  35        0      6
  36        2      6
  37        1      6
  38        0      7
  39        0      5
  40        1      7
  41        1      5
  42        0      8
  43        2      5
  44        1      8
  45       -2     -2
  46        3      4
  47        2      8
  48        3      5
  49        3      6
  50        4      4
  51        3      7
  52        5      4
  53        3      8
  54        6      4
  55        4      8
  56       -2     -2
  57        5      5
  58        5      8
  59        4      5
  60        6      8
  61        6      5
  62        5      7
  63        6      6
  64        4      7
  65        4      6
  66        6      7
  67        5      6
