# Ch PadLayer PadRow
   0        5      6
   1        6      7
   2        4      6
   3        4      7
   4        6      6
   5        5      7
   6        6      5
   7        6      8
   8        4      5
   9        5      8
  10        5      5
  11       -2     -2
  12        4      8
  13        6      4
  14        3      8
  15        5      4
  16        3      7
  17        4      4
  18        3      6
  19        3      5
  20        2      8
  21        3      4
  22       -2     -2
  23        1      8
  24        2      5
  25        0      8
  26        1      5
  27        1      7
  28        0      5
  29        0      7
  30        1      6
  31        2      6
  32        0      6
  33        2      7
  34        5      1
  35        5      2
  36        4      1
  37        4      2
  38        6      1
  39        6      2
  40        6      0
  41        6      3
  42        5      0
  43        5      3
  44        4      0
  45       -2     -2
  46        4      3
  47        3      0
  48        3      3
  49        3      1
  50        2      4
  51        3      2
  52        1      4
  53        2      0
  54        0      4
  55        1      0
  56       -2     -2
  57        2      3
  58        0      0
  59        1      3
  60        2      1
  61        0      3
  62        1      1
  63        2      2
  64        0      2
  65        1      2
  66        0      1
  67       -2     -2
