# UAIdx CoBoIdx AsAdIdx
    000       0       0
    001       0       1
    002       0       2
    003       0       3
    004       1       0
    005       1       1
    006       3       0
    007       3       1
    008       3       2
    009       3       3
    010       4       0
    011       4       1
    100       1       2
    101       1       3
    102       2       0
    103       2       1
    104       2       2
    105       2       3
    106       4       2
    107       4       3
    108       5       0
    109       5       1
    110       5       2
    111       5       3
    209       6       0
    210       6       1
    211       6       2
