# UAIdx CoBoIdx AsAdIdx
    000       0       0
    001       0       1
    002       0       2
    003       0       3
    004       1       0
    005       1       1
    006       3       0
    007       3       1
    008       3       2
    009       3       3
    010       4       0
    011       4       1
    100       1       2
    101       1       3
    102       2       0
    103       2       1
    104       2       2
    105       2       3
    106       4       2
    107       4       3
    108       5       0
    109       5       1
    110       5       2
    111       5       3
    200       6       0
    201       6       1
    202       6       2
    203       6       3
    204       7       0
    205       7       1
    206       9       0
    207       9       1
    208       9       2
    209       9       3
    210      10       0
    211      10       1
    300       7       2
    301       7       3
    302       8       0
    303       8       1
    304       8       2
    305       8       3
    306      10       2
    307      10       3
    308      11       0
    309      11       1
    310      11       2
    311      11       3
